1 6
05 05 05 05 05 05 05 05 05 05 05 05 05 05 05 05 05 05 05 05 
05 00 00 00 00 00 00 00 00 00 00 00 00 00 00 00 00 00 00 05 
05 00 00 00 00 00 00 00 00 00 00 00 00 00 00 00 00 00 00 05 
05 00 00 00 00 00 00 00 00 00 00 00 00 00 00 00 00 00 00 05 
05 00 00 00 00 00 00 00 00 00 00 00 00 00 00 00 00 00 00 05 
05 00 00 00 00 00 00 00 00 00 00 00 00 00 00 00 00 00 00 05 
05 00 00 00 00 00 00 00 00 00 00 00 00 00 00 00 00 00 00 05 
05 00 00 00 00 00 00 00 00 00 00 00 00 00 00 00 00 00 00 05 
05 00 00 00 00 00 00 00 00 00 00 00 00 00 00 00 00 00 00 05 
05 00 00 00 00 00 00 00 00 00 00 00 00 00 00 00 00 00 00 05 
05 00 00 00 00 00 00 00 00 00 00 00 00 00 00 00 00 00 00 05 
05 00 00 00 00 00 00 00 00 00 00 00 00 00 00 00 00 00 00 05 
05 00 00 00 00 00 00 00 00 00 00 00 00 00 00 00 00 00 00 05 
05 00 00 00 00 00 00 00 00 00 00 00 00 00 00 00 00 00 00 05 
05 00 00 00 00 00 00 00 00 00 00 00 00 00 00 00 00 00 00 05 
05 00 00 00 00 00 00 00 00 00 00 00 00 00 00 00 00 00 00 05 
05 00 00 00 00 00 00 00 00 00 00 00 00 00 00 00 00 00 00 05 
05 00 00 00 00 00 00 00 00 00 00 00 00 00 00 00 00 00 00 05 
05 00 00 00 00 00 00 00 00 00 00 00 00 00 00 00 00 00 00 05 
05 00 00 00 00 00 00 00 00 00 00 00 00 00 00 00 00 00 00 05 
05 00 00 00 00 00 00 00 00 00 00 00 00 00 00 00 00 00 00 05 
05 00 00 00 00 00 00 00 00 00 00 00 00 00 00 00 00 00 00 05 
05 00 00 00 00 00 00 00 00 00 00 00 00 00 00 00 00 00 00 05 
05 00 00 00 00 00 00 00 00 00 00 00 00 00 00 00 00 00 00 05 
05 00 00 00 00 00 00 00 00 00 00 00 00 00 00 00 00 00 00 05 
05 00 00 00 00 00 00 00 00 00 00 00 00 00 00 00 00 00 00 05 
05 00 00 00 00 00 00 00 00 00 00 00 00 00 00 00 00 00 00 05 
05 00 00 00 00 00 00 00 00 00 00 00 00 00 00 00 00 00 00 05 
05 00 00 00 00 00 00 00 00 00 00 00 00 00 00 00 00 00 00 05 
05 00 00 00 00 00 00 00 00 00 00 00 00 00 00 00 00 00 00 05 
05 00 00 00 00 00 00 00 00 00 00 00 00 00 00 00 00 00 00 05 
05 00 00 00 00 00 00 00 00 00 00 00 00 00 00 00 00 00 00 05 
05 00 00 00 00 00 00 00 00 00 00 00 00 00 00 00 00 00 00 05 
05 00 00 00 00 00 00 00 00 00 00 00 00 00 00 00 00 00 00 05 
05 00 00 00 00 00 00 00 00 00 00 00 00 00 00 00 00 00 00 05 
05 00 00 00 00 00 00 00 00 00 00 00 00 00 00 00 00 00 00 05 
05 00 00 00 00 00 00 00 00 00 00 00 00 00 00 00 00 00 00 05 
05 00 00 00 00 00 00 00 00 00 00 00 00 00 00 00 00 00 00 05 
05 00 00 00 00 00 00 00 00 00 00 00 00 00 00 00 00 00 00 05 
05 00 00 00 00 00 00 00 00 00 00 00 00 00 00 00 00 00 00 05 
05 00 00 00 00 00 00 00 00 00 00 00 00 00 00 00 00 00 00 05 
05 00 00 00 00 00 00 00 00 00 00 00 00 00 00 00 00 00 00 05 
05 00 00 00 00 00 00 00 00 00 00 00 00 00 00 00 00 00 00 05 
05 00 00 00 00 00 00 00 00 00 00 00 00 00 00 00 00 00 00 05 
05 00 00 00 00 00 00 00 00 00 00 00 00 00 00 00 00 00 00 05 
05 00 00 00 00 00 00 00 00 00 00 00 00 00 00 00 00 00 00 05 
05 00 00 00 00 00 00 00 00 00 00 00 00 00 00 00 00 00 00 05 
05 00 00 00 00 00 00 00 00 00 00 00 00 00 00 00 00 00 00 05 
05 00 00 00 00 00 00 00 00 00 00 00 00 00 00 00 00 00 00 05 
05 00 00 00 00 00 00 00 00 00 00 00 00 00 00 00 00 00 00 05 
05 00 00 00 00 00 00 00 00 00 00 00 00 00 00 00 00 00 00 05 
05 00 00 00 00 00 00 00 00 00 00 00 00 00 00 00 00 00 00 05 
05 00 00 00 00 00 00 00 00 00 00 00 00 00 00 00 00 00 00 05 
05 00 00 00 00 00 00 00 00 00 00 00 00 00 00 00 00 00 00 05 
05 00 00 00 00 00 00 00 00 00 00 00 00 00 00 00 00 00 00 05 
05 00 00 00 00 00 00 00 00 00 00 00 00 00 00 00 00 00 00 05 
05 00 00 00 00 00 00 00 00 00 00 00 00 00 00 00 00 00 00 05 
05 00 00 00 00 00 00 00 00 00 00 00 00 00 00 00 00 00 00 05 
05 00 00 00 00 00 00 00 00 00 00 00 00 00 00 00 00 00 00 05 
05 00 00 00 00 00 00 00 00 00 00 00 00 00 00 00 00 00 00 05 
05 00 00 00 00 00 00 00 00 00 00 00 00 00 00 00 00 00 00 05 
05 00 00 00 00 00 00 00 00 00 00 00 00 00 00 00 00 00 00 05 
05 00 00 00 00 00 00 00 00 00 00 00 00 00 00 00 00 00 00 05 
05 00 00 00 00 00 00 00 00 00 00 00 00 00 00 00 00 00 00 05 
05 00 00 00 00 00 00 00 00 00 00 00 00 00 00 00 00 00 00 05 
05 00 00 00 00 00 00 00 00 00 00 00 00 00 00 00 00 00 00 05 
05 00 00 00 00 00 00 00 00 00 00 00 00 00 00 00 00 00 00 05 
05 00 00 00 00 00 00 00 00 00 00 00 00 00 00 00 00 00 00 05 
05 00 00 00 00 00 00 00 00 00 00 00 00 00 00 00 00 00 00 05 
05 00 00 00 00 00 00 00 00 00 00 00 00 00 00 00 00 00 00 05 
05 00 00 00 00 00 00 00 00 00 00 00 00 00 00 00 00 00 00 05 
05 00 00 00 00 00 00 00 00 00 00 00 00 00 00 00 00 00 00 05 
05 00 00 00 00 00 00 00 00 00 00 00 00 00 00 00 00 00 00 05 
05 00 00 00 00 00 00 00 00 00 00 00 00 00 00 00 00 00 00 05 
05 00 00 00 00 00 00 00 00 00 00 00 00 00 00 00 00 00 00 05 
05 00 00 00 00 00 00 00 00 00 00 00 00 00 00 00 00 00 00 05 
05 00 00 00 00 00 00 00 00 00 00 00 00 00 00 00 00 00 00 05 
05 00 00 00 00 00 00 00 00 00 00 00 00 00 00 00 00 00 00 05 
05 00 00 00 00 00 00 00 00 00 00 00 00 00 00 00 00 00 00 05 
05 00 00 00 00 00 00 00 00 00 00 00 00 00 00 00 00 00 00 05 
05 00 00 00 00 00 00 00 00 00 00 00 00 00 00 00 00 00 00 05 
05 00 00 00 00 00 00 00 00 00 00 00 00 00 00 00 00 00 00 05 
05 00 00 00 00 00 00 00 00 00 00 00 00 00 00 00 00 00 00 05 
05 00 00 00 00 00 00 00 00 00 00 00 00 00 00 00 00 00 00 00 
05 00 00 00 00 00 00 00 00 00 00 00 00 00 00 00 00 00 00 00 
05 00 00 00 00 00 00 00 00 00 00 00 00 00 00 00 00 00 00 00 
05 00 00 00 00 00 00 00 00 00 00 00 00 00 00 00 00 00 00 00 
05 00 00 00 00 00 00 00 00 00 00 00 00 00 00 00 00 00 00 00 
05 00 00 00 00 00 00 00 00 00 00 00 00 00 00 00 00 00 00 00 
08 08 08 08 08 08 08 08 08 08 08 08 08 08 08 08 08 08 08 08 
