4 2
04 04 04 04 04 04 04 04 04 04 04 04 04 04 04 04 04 04 04 04 04 04 04 04 04 04 04 04 04 04 04 04 04 04 04 04 04 04 04 04 04 04 04 04 04 04 04 04 04 04 04 04 04 04 04 04 04 04 04 04 04 04 04 04 04 04 04 04 04 04 04 04 04 04 04 04 04 04 04 04 
04 04 04 04 04 04 04 04 04 04 04 04 04 04 04 04 04 04 04 04 04 04 04 04 04 04 04 04 04 04 04 04 04 04 04 04 04 04 04 04 04 04 04 04 04 04 04 04 04 04 04 04 04 04 04 04 04 04 04 04 04 04 04 04 04 04 04 04 04 04 04 04 04 04 04 04 04 04 04 04 
04 04 04 04 04 04 00 00 00 00 00 00 00 04 04 04 04 04 04 04 04 04 04 04 00 00 00 00 00 00 00 00 00 00 00 00 00 00 00 00 04 04 04 04 04 04 00 00 00 00 04 00 00 00 00 04 00 00 00 00 04 00 00 00 00 04 00 00 00 00 04 00 00 00 00 04 04 04 04 04 
04 04 04 04 00 00 00 00 00 00 00 00 00 00 00 04 04 04 00 00 00 00 00 00 00 00 00 00 00 00 00 00 00 00 00 00 00 00 00 00 00 00 04 04 04 04 00 00 00 00 04 00 00 00 00 04 00 00 00 00 04 00 00 00 00 04 00 00 00 00 04 00 00 00 00 04 04 00 00 04 
00 00 00 00 00 00 00 00 00 00 00 00 00 00 00 04 04 04 00 00 00 00 00 00 00 00 00 00 00 00 00 00 00 00 00 00 00 00 00 00 00 00 04 04 04 04 00 00 00 00 04 00 00 00 00 04 00 00 00 00 04 00 00 00 00 04 00 00 00 00 04 00 00 00 00 04 00 00 00 04 
00 00 00 00 00 00 00 00 00 00 00 00 00 00 00 04 04 00 00 00 00 00 00 00 00 00 00 00 06 06 06 06 06 06 06 06 00 00 00 00 00 00 00 00 04 04 00 00 00 00 04 00 00 00 00 04 00 00 00 00 04 00 00 00 00 04 00 00 00 00 04 00 00 00 00 04 00 00 00 04 
00 00 00 00 00 00 00 06 06 06 06 06 00 00 00 00 00 00 00 00 00 00 00 00 00 06 06 06 04 04 04 04 04 04 04 04 06 06 00 00 00 00 00 00 04 00 00 00 00 00 00 00 00 00 00 00 00 00 00 00 00 00 00 00 00 00 00 00 00 00 00 00 00 00 00 00 00 00 00 00 
00 00 00 00 00 00 06 04 04 04 04 04 00 00 00 00 00 00 00 00 00 00 06 06 06 04 04 00 00 00 00 00 04 04 04 04 04 04 06 00 00 00 00 00 00 00 00 00 00 00 00 00 00 00 00 00 00 00 00 00 00 00 00 00 00 00 00 00 00 00 00 00 00 00 00 00 00 00 00 00 
00 00 00 00 00 00 00 00 00 04 04 04 00 00 00 00 00 00 00 00 00 00 04 04 04 00 00 00 00 00 00 00 00 00 00 00 00 00 04 06 00 00 00 00 00 00 00 00 00 00 00 00 00 00 00 00 00 00 00 00 00 00 00 00 00 00 00 00 00 00 00 00 00 00 00 00 00 00 00 00 
00 00 00 00 00 00 00 00 00 00 00 00 00 00 00 00 00 00 00 00 00 00 00 00 00 00 00 00 00 00 00 00 00 00 00 00 00 00 00 00 00 00 00 00 00 00 00 00 00 00 00 00 00 00 00 00 00 00 00 00 00 00 00 00 00 00 00 00 00 00 00 00 00 00 06 06 06 06 06 06 
06 06 06 00 00 00 00 00 00 00 00 00 00 00 00 06 06 00 00 00 00 00 00 00 00 00 00 00 00 00 00 00 00 00 00 00 00 00 00 00 00 00 00 00 00 06 06 00 00 06 06 06 00 00 06 06 06 00 00 06 06 06 00 00 06 06 06 00 00 06 06 06 00 00 04 04 04 04 04 04 
04 04 04 06 00 00 00 00 00 00 00 00 00 00 00 04 04 06 06 00 00 00 00 00 00 00 00 06 06 06 06 06 06 06 00 00 00 00 00 00 00 00 00 00 06 04 04 00 00 04 04 04 00 00 04 04 06 00 00 04 04 04 00 00 04 04 04 00 00 04 04 04 00 00 04 04 04 04 04 04 
04 04 04 04 06 06 06 00 00 00 00 00 00 00 06 04 04 04 04 06 06 00 00 00 00 06 06 04 04 04 04 04 04 04 06 06 00 00 00 00 00 06 06 06 04 04 04 06 06 04 04 04 06 06 04 04 04 06 06 04 04 04 06 06 04 04 04 06 06 04 04 04 06 06 04 04 04 04 04 04 
04 04 04 04 04 04 04 06 06 06 06 06 06 06 04 04 04 04 04 04 04 06 06 06 06 06 04 04 04 04 04 04 04 04 04 04 06 06 06 06 06 04 04 04 04 04 04 04 04 04 04 04 04 04 04 04 04 04 04 04 04 04 04 04 04 04 04 04 04 04 04 04 04 04 04 04 04 04 04 04 
04 04 04 04 04 04 04 04 04 04 04 04 04 04 04 04 04 04 04 04 04 04 04 04 04 04 04 04 04 04 04 04 04 04 04 04 04 04 04 04 04 04 04 04 04 04 04 04 04 04 04 04 04 04 04 04 04 04 04 00 00 00 00 00 00 04 04 04 04 04 04 04 04 04 04 04 04 04 04 04 
04 04 04 04 04 04 04 04 04 04 04 04 04 04 04 04 04 04 04 04 04 04 04 04 04 04 04 04 04 04 04 04 04 04 04 04 04 04 04 00 00 00 00 00 00 00 00 00 04 04 04 04 04 04 04 04 00 00 00 00 00 00 06 06 06 04 04 04 04 04 04 00 00 00 00 00 04 04 04 04 
04 04 04 04 04 04 04 04 04 04 00 00 00 00 00 00 00 00 04 04 04 04 04 04 04 04 04 00 00 00 00 00 00 00 00 00 00 00 00 00 00 00 00 00 00 00 00 00 00 00 00 04 04 04 04 00 00 00 00 00 00 06 04 04 04 04 04 00 00 00 00 00 00 00 00 00 00 04 04 04 
04 04 04 04 04 04 00 00 00 00 00 00 00 00 00 00 00 00 00 00 00 00 00 04 04 04 04 00 00 00 00 00 00 00 00 00 00 00 00 00 00 00 00 00 00 00 00 00 00 00 00 04 04 04 00 00 00 00 00 00 06 04 04 04 00 00 00 00 00 00 00 00 00 00 00 00 00 00 04 04 
04 04 04 00 00 00 00 00 00 00 00 00 00 00 00 00 00 00 00 00 00 00 00 00 04 04 04 00 00 00 00 00 00 00 00 00 00 00 00 00 00 00 00 00 00 00 00 00 00 00 00 00 04 04 00 00 00 00 00 00 04 04 04 00 00 00 00 00 00 00 00 00 00 00 00 00 00 00 04 04 
04 00 00 00 00 00 00 00 00 00 00 00 00 00 00 00 00 00 00 00 00 00 00 00 00 04 04 06 06 00 00 00 06 06 06 06 06 00 00 00 00 00 00 00 00 00 00 00 00 00 00 00 04 04 06 00 00 00 00 00 04 04 00 00 00 00 00 00 00 00 00 06 06 06 00 00 00 00 04 04 
00 00 00 00 00 00 00 00 00 00 00 00 00 00 00 00 00 00 00 00 00 00 00 00 00 00 04 04 04 00 00 00 00 00 00 00 00 00 00 00 00 00 00 00 00 00 00 00 00 00 00 00 04 04 04 06 06 00 00 00 00 00 00 00 00 00 00 00 00 06 06 04 04 04 06 00 00 00 00 04 
00 00 00 00 00 00 00 00 00 00 00 00 00 00 06 06 06 06 06 06 06 06 00 00 00 00 04 04 04 06 00 00 00 00 00 00 00 00 00 00 00 00 06 06 06 00 00 00 00 00 00 00 00 00 00 00 00 00 00 00 00 00 00 00 00 00 00 00 00 04 04 04 04 04 04 06 00 00 00 04 
00 00 00 00 00 00 00 06 06 06 06 06 06 06 04 04 04 04 04 04 04 00 00 00 00 00 04 04 04 04 00 00 00 00 00 00 00 06 06 06 06 06 04 04 04 00 00 00 00 00 00 00 00 00 00 00 00 00 00 00 00 00 00 00 00 00 00 00 00 00 00 04 04 04 00 00 00 00 00 04 
00 00 00 00 00 00 00 00 00 00 04 04 04 04 04 04 04 04 04 00 00 00 00 00 00 00 04 04 04 04 00 00 06 06 06 06 06 04 04 04 04 04 04 04 04 00 00 06 06 00 00 00 00 00 00 00 00 00 00 06 06 06 06 06 06 00 00 00 00 00 00 00 00 00 00 00 00 00 00 04 
00 00 00 00 00 00 00 00 00 00 00 00 00 00 04 04 04 00 00 00 00 00 00 00 00 04 04 04 04 04 06 06 04 04 04 04 04 04 04 00 00 00 00 00 00 00 00 00 00 00 00 00 00 00 06 06 06 06 06 04 04 04 04 04 04 06 06 00 00 00 00 00 00 00 00 00 00 00 00 04 
00 00 00 00 00 00 00 00 00 00 00 00 00 00 00 00 00 00 00 00 00 00 00 00 00 04 04 04 04 04 04 04 04 04 04 04 00 00 00 00 00 00 00 00 00 00 00 00 00 00 00 06 06 06 04 04 04 04 04 04 04 04 04 04 04 04 04 00 00 00 00 00 00 00 00 00 00 00 00 04 
06 06 06 06 06 06 00 00 00 00 00 00 00 00 00 00 00 00 00 00 00 00 00 00 00 00 00 00 00 00 00 00 00 00 00 00 00 00 00 00 00 00 00 00 00 00 00 00 00 00 06 06 06 04 04 00 00 00 00 00 00 00 00 00 00 00 00 00 00 00 00 00 00 00 00 00 00 00 00 04 
04 04 04 04 04 04 06 00 00 00 00 00 00 00 00 00 00 00 00 00 00 00 00 00 00 00 00 00 00 00 00 00 00 00 00 00 00 00 00 00 00 00 00 00 00 00 00 00 06 06 04 04 04 04 00 00 00 00 00 00 00 00 00 00 00 00 00 00 00 00 00 00 00 00 00 00 00 00 00 04 
04 04 04 04 04 04 04 06 00 00 00 00 00 00 00 00 00 00 00 00 00 00 00 00 00 00 00 00 00 00 00 00 00 00 00 00 00 00 00 00 00 00 00 00 00 00 00 00 04 04 04 04 00 00 00 00 00 00 00 00 00 00 00 00 00 00 00 00 00 00 00 06 06 06 06 06 06 06 06 04 
04 04 04 04 04 04 04 04 06 06 06 06 06 06 06 06 06 06 06 06 06 06 06 06 06 06 06 06 06 06 06 06 06 06 06 06 06 06 06 06 06 06 06 06 06 06 06 06 04 04 04 04 06 06 06 06 06 06 06 06 06 06 06 06 06 06 06 06 06 06 06 04 04 04 04 04 04 04 04 04 
