2 2
05 05 05 05 05 05 05 05 05 05 05 05 05 05 05 05 05 05 05 05 05 05 05 05 05 05 05 05 05 05 05 05 05 05 05 05 05 05 05 05 
00 00 00 00 00 00 00 00 00 00 00 00 00 00 00 00 00 00 00 00 00 00 00 00 00 00 00 00 00 00 00 00 00 00 00 00 00 00 00 00 
00 00 00 00 00 00 00 00 00 00 00 00 00 00 00 00 00 00 00 00 00 00 00 00 00 00 00 00 00 00 00 00 00 00 00 00 00 00 00 00 
00 00 00 00 00 00 00 00 00 00 00 00 00 00 00 00 00 00 00 00 00 00 00 00 00 00 00 00 00 00 00 00 00 00 00 00 00 00 00 00 
00 00 00 00 00 00 00 00 00 00 00 00 00 00 00 00 00 00 00 00 00 00 00 00 00 00 00 00 00 00 00 011 010 011 012 013 00 00 00 00 
00 00 00 00 00 00 00 00 00 00 00 00 00 00 00 00 00 00 00 00 00 00 00 00 00 00 00 00 00 00 00 00 09 00 00 00 00 00 00 00 
010 011 00 00 00 00 015 014 013 012 011 09 00 00 00 00 00 00 00 00 00 00 00 00 00 00 00 00 00 00 00 00 09 00 00 00 00 00 00 00 
09 00 00 00 00 00 00 00 00 00 00 09 011 012 013 014 00 00 00 00 014 013 012 012 011 010 00 00 00 00 00 00 09 00 00 00 00 00 00 00 
09 00 00 00 00 00 00 00 00 00 00 09 00 00 00 00 00 00 00 00 00 00 00 00 00 010 011 012 013 014 00 00 09 00 00 013 012 011 010 011 
09 00 00 00 00 00 00 00 00 00 00 09 00 00 00 00 00 00 00 00 00 00 00 00 00 09 00 00 00 00 00 00 09 00 00 00 00 00 09 00 
09 00 00 00 00 00 00 00 00 00 00 09 00 00 00 00 00 00 00 00 00 00 00 00 00 09 00 00 00 00 00 00 09 00 00 00 00 00 09 00 
09 00 00 00 00 00 00 00 00 00 00 09 00 00 00 00 00 00 00 00 00 00 00 00 00 09 00 00 00 00 00 00 09 00 00 00 00 00 09 00 
010 011 012 00 00 00 014 013 012 011 09 09 00 00 00 00 00 00 00 00 00 00 00 00 00 09 00 00 00 00 00 00 09 00 00 00 00 00 09 00 
09 00 00 00 00 00 00 00 00 00 09 09 011 012 013 014 015 00 00 00 00 014 013 012 011 010 011 012 013 014 00 00 09 00 00 00 00 00 09 00 
09 00 00 00 00 00 00 00 00 00 00 09 00 00 00 00 00 00 00 00 00 00 00 00 00 09 00 00 00 00 00 00 09 00 00 00 00 00 09 00 
09 00 00 00 00 00 00 00 00 00 00 09 00 00 00 00 00 00 00 00 00 00 00 00 00 09 00 00 00 00 00 00 09 00 014 013 012 011 010 011 
09 00 00 00 00 00 00 00 00 00 00 09 00 00 00 00 00 00 00 00 00 00 00 00 00 09 00 00 00 00 00 00 09 00 00 00 00 00 09 00 
09 00 00 00 00 00 00 00 00 00 00 09 00 00 00 00 00 00 00 00 00 00 00 00 00 09 00 00 00 00 00 00 09 00 00 00 00 00 09 00 
09 00 00 00 00 00 00 00 00 00 09 09 011 012 013 014 00 00 00 013 012 011 010 011 012 09 00 00 00 00 00 00 09 00 00 00 00 00 09 00 
09 011 012 013 00 00 00 013 012 011 09 09 00 00 00 00 00 00 00 00 00 00 09 00 00 09 00 00 00 012 012 011 010 011 012 012 00 00 09 00 
09 00 00 00 00 00 00 00 00 00 00 09 00 00 00 00 00 00 00 00 00 00 09 00 00 09 00 00 00 00 00 00 09 00 00 00 00 00 09 00 
09 00 00 00 00 00 00 00 00 00 00 09 00 00 00 00 00 00 00 00 00 00 09 00 00 09 00 00 00 00 00 00 09 00 00 00 00 00 09 00 
09 00 00 00 00 00 00 00 00 00 00 09 00 00 00 00 00 00 010 010 011 012 09 00 00 09 00 00 00 00 00 00 09 00 00 00 00 00 09 00 
09 00 00 00 00 00 00 00 00 00 00 010 011 012 00 00 00 011 010 09 00 00 09 00 00 09 015 014 014 013 012 011 010 011 012 013 012 011 010 011 
09 00 00 00 00 00 00 00 013 012 011 010 00 00 00 00 00 00 00 09 00 00 09 00 00 09 00 00 00 00 00 00 09 00 00 00 00 00 09 00 
09 00 00 00 00 00 00 00 00 00 00 09 00 00 00 00 00 00 00 09 00 00 09 00 00 09 00 00 00 00 00 00 09 00 00 00 00 00 09 00 
09 00 00 00 00 00 00 00 00 00 00 09 00 00 00 00 00 00 00 09 00 00 09 00 00 09 00 00 00 00 00 00 09 00 00 00 00 00 09 00 
09 00 00 00 00 00 00 00 00 00 00 09 00 00 00 00 00 00 00 09 00 00 09 00 00 09 00 00 00 00 00 00 09 00 00 00 00 00 09 00 
09 00 00 00 00 00 00 00 00 00 00 09 00 00 00 00 00 00 00 09 00 00 09 00 00 08 08 08 08 08 08 08 08 08 08 08 08 08 08 08 
08 08 08 08 08 08 08 08 08 08 08 08 08 08 08 08 08 08 08 08 08 08 08 08 08 07 07 07 07 07 07 07 07 07 07 07 07 07 07 07 
