2 2
04 04 04 04 04 08 05 05 05 05 05 05 05 05 05 05 05 05 05 05 05 05 05 05 05 05 05 05 05 05 05 05 05 05 05 05 05 05 05 05 
04 04 04 04 04 07 08 00 00 00 00 00 00 00 00 00 00 00 00 00 00 00 00 00 00 00 00 00 00 00 00 00 00 00 00 00 00 00 00 00 
04 04 04 04 04 04 07 08 00 00 00 00 00 00 00 00 00 00 00 00 00 00 00 00 00 00 00 00 00 00 00 00 00 00 00 00 00 00 00 00 
04 04 04 04 04 04 04 07 00 00 00 00 00 00 00 00 00 00 00 00 00 00 00 00 00 00 00 00 00 00 00 00 00 00 00 00 00 00 00 00 
04 04 04 04 04 04 04 07 08 00 00 00 00 00 00 00 00 00 00 00 00 00 00 00 00 00 00 00 00 00 00 00 00 00 00 00 00 00 00 00 
04 04 04 04 04 04 04 04 07 08 08 00 00 00 00 00 00 00 00 00 00 00 00 00 00 00 00 00 00 00 00 00 00 00 00 00 00 00 00 00 
00 00 00 00 00 00 00 00 00 00 00 00 00 00 00 00 00 00 00 00 00 00 00 00 00 00 012 011 010 011 012 00 00 00 00 00 00 00 00 00 
00 00 00 00 00 00 00 00 00 00 00 00 00 00 00 00 00 00 00 00 00 00 00 00 00 00 00 00 09 00 00 00 00 00 00 00 00 00 00 00 
00 00 00 00 00 00 00 00 00 00 00 00 00 00 00 00 00 00 00 00 00 00 00 00 00 00 00 00 09 00 00 00 00 00 00 00 00 00 00 00 
04 04 04 04 04 04 08 08 08 08 08 08 00 00 00 00 00 00 00 00 00 00 00 00 00 00 00 00 09 00 00 00 00 00 00 00 00 00 00 00 
04 04 04 04 04 04 04 04 04 04 04 07 00 00 00 00 00 00 00 00 00 00 00 00 00 00 00 00 09 00 00 00 00 00 00 00 00 00 00 00 
04 04 04 04 04 04 04 04 04 04 04 07 08 00 00 00 00 00 00 00 00 00 00 00 00 00 00 00 010 011 012 013 00 00 00 00 00 00 00 00 
04 04 04 04 04 04 04 04 04 04 04 04 07 08 00 00 00 00 00 00 00 00 00 00 00 014 013 012 09 00 00 00 00 00 00 00 00 00 00 00 
04 04 04 04 04 04 04 04 04 04 04 04 04 07 00 00 00 00 00 00 00 00 00 00 00 00 00 00 09 00 00 00 00 00 00 00 00 00 00 00 
04 04 04 04 04 04 04 04 04 04 04 04 04 07 08 00 00 00 00 00 00 00 00 00 00 00 00 00 09 00 00 00 00 00 00 00 00 00 00 00 
04 04 04 04 04 04 04 04 04 04 04 04 04 04 07 00 00 00 00 00 00 00 00 00 00 00 00 00 09 00 00 00 00 08 08 08 08 08 08 08 
04 04 04 04 04 04 04 04 04 04 04 04 04 00 00 00 00 00 00 00 00 00 00 00 00 00 00 00 09 00 00 00 00 00 07 07 07 07 07 07 
04 04 04 04 04 04 04 04 04 04 04 00 00 00 00 00 00 00 00 00 00 00 00 00 00 013 012 011 010 00 00 00 00 00 00 07 07 07 07 07 
04 04 04 04 04 04 04 04 04 04 00 00 00 00 00 00 00 00 00 00 00 00 00 00 00 00 00 00 010 011 012 013 00 00 00 00 07 07 07 07 
04 04 04 04 04 04 04 04 00 00 00 00 00 00 08 08 08 08 00 00 00 00 00 00 00 00 00 00 09 00 00 00 00 00 00 00 00 00 00 00 
04 04 00 00 00 00 00 00 00 00 00 00 00 08 07 07 07 07 00 00 00 00 00 00 00 00 00 00 09 00 00 00 00 00 00 00 00 00 00 00 
04 04 00 00 00 00 00 00 00 00 00 00 08 07 04 04 04 07 08 00 00 00 00 00 00 00 00 00 09 00 00 00 00 00 00 00 00 00 00 00 
04 04 00 00 00 00 00 00 00 00 00 08 07 04 04 04 04 04 07 08 00 00 00 00 00 00 00 00 09 00 00 00 00 00 00 00 00 00 00 00 
04 04 00 00 00 00 00 00 00 00 08 07 04 04 04 04 04 04 04 07 00 00 00 00 00 013 013 011 010 011 012 013 00 00 00 00 00 00 00 00 
04 04 00 00 00 00 00 00 00 00 07 04 04 04 04 04 04 04 04 07 00 00 00 00 00 00 00 00 09 00 00 00 00 00 00 00 00 00 00 00 
04 04 00 00 00 00 00 08 08 00 07 04 04 04 04 04 04 04 04 07 08 00 00 00 00 00 00 00 09 00 00 00 00 00 00 00 00 00 00 00 
04 04 00 00 00 00 00 00 00 00 04 04 04 04 04 04 04 04 04 07 07 08 08 00 00 00 00 00 09 00 00 00 00 00 00 00 08 08 08 08 
04 04 00 00 00 04 04 04 04 04 04 04 04 04 04 04 04 04 04 04 07 07 07 07 07 00 00 00 09 00 00 00 00 00 08 08 07 07 07 07 
04 04 04 04 04 04 04 04 04 04 04 04 04 04 04 04 04 04 04 04 04 04 04 07 07 08 00 00 09 00 00 00 08 08 07 07 07 07 07 07 
04 04 04 04 04 04 04 04 04 04 04 04 04 04 04 04 04 04 04 04 04 04 04 04 07 07 08 08 08 08 08 08 07 07 07 07 07 07 07 07 
