4 2
05 05 05 05 05 05 05 05 05 05 05 05 05 05 05 05 05 05 07 07 04 04 04 04 04 04 04 04 04 04 04 04 04 04 04 04 04 04 04 04 04 04 04 04 04 04 04 04 04 04 04 04 04 04 04 04 04 04 04 04 04 04 04 04 04 04 04 04 04 04 04 04 04 04 04 04 04 04 04 04 
05 00 00 00 00 00 00 00 00 00 00 00 00 00 00 00 00 00 07 04 04 04 04 04 04 04 04 04 04 04 04 04 04 04 04 04 04 04 04 04 04 04 04 04 04 04 04 04 04 04 04 04 04 04 04 04 04 04 04 04 04 04 04 04 04 04 04 04 04 04 04 04 04 04 04 04 04 04 04 04 
05 00 00 00 00 00 00 00 00 00 00 00 00 00 00 00 00 00 07 04 04 04 04 04 04 04 04 04 04 04 00 00 04 04 04 04 04 00 00 00 04 04 04 04 04 04 04 04 04 04 04 04 04 04 04 04 04 04 04 04 04 04 04 04 04 00 00 00 00 04 04 04 04 00 00 00 04 04 04 04 
05 00 00 00 00 00 00 00 00 00 00 00 00 00 00 00 00 00 07 04 04 04 04 04 04 00 00 00 00 00 00 00 00 04 04 00 00 00 00 00 00 00 00 00 04 04 04 04 04 04 04 04 04 04 04 04 04 04 00 00 00 00 00 00 00 00 00 00 00 00 00 00 00 00 00 00 00 00 00 04 
05 00 00 00 00 00 00 00 00 00 00 00 00 00 00 00 00 08 07 04 04 04 00 00 00 00 00 00 00 00 00 00 00 00 00 00 00 00 00 00 00 00 00 00 00 00 00 04 04 04 04 04 04 04 04 04 04 00 00 00 00 00 00 00 00 00 00 00 00 00 00 00 00 00 00 00 00 00 00 00 
05 00 00 00 00 00 00 00 00 00 00 00 00 00 00 00 00 07 04 04 04 00 00 00 00 00 00 00 00 00 00 00 00 00 00 00 00 00 00 00 00 00 00 00 00 00 00 00 00 04 04 04 04 04 04 04 00 00 00 00 00 00 00 00 00 00 00 00 00 00 00 00 00 00 00 00 00 00 00 00 
05 00 00 00 00 00 00 00 00 00 00 00 00 00 00 00 00 07 04 04 00 00 00 00 00 00 00 00 00 00 00 00 00 00 00 00 00 00 00 00 00 00 00 00 00 00 00 00 00 04 04 04 04 04 04 00 00 00 00 00 00 00 00 00 00 00 06 06 06 06 06 06 06 06 06 06 00 00 00 00 
05 00 00 00 00 00 00 00 00 00 00 00 00 00 00 00 08 07 04 04 06 06 06 06 06 06 06 06 06 06 06 06 06 00 00 00 00 00 00 00 00 00 00 00 00 06 00 00 00 00 04 04 04 04 00 00 00 00 00 00 00 06 06 06 06 06 04 04 04 04 04 04 04 00 00 00 00 00 00 00 
05 00 00 00 00 00 00 00 00 00 00 00 00 00 00 00 07 04 04 04 04 04 04 04 04 04 04 04 04 04 04 04 04 06 06 06 00 00 00 00 00 00 00 06 06 04 06 06 06 06 04 04 04 04 00 00 00 00 00 00 06 06 04 04 04 04 04 04 04 04 04 00 00 00 00 00 00 00 00 00 
05 00 00 00 00 00 00 00 00 00 00 00 00 00 00 00 07 04 04 04 04 04 04 04 04 04 04 04 04 04 00 00 00 00 00 00 00 00 00 00 00 00 00 00 04 04 04 04 04 04 04 04 04 00 00 00 00 00 06 06 04 04 00 00 00 00 00 00 00 00 00 00 00 00 00 00 00 00 00 00 
05 00 00 00 00 00 00 00 00 00 00 00 00 00 00 08 07 04 04 04 04 00 00 00 00 00 00 00 00 00 00 00 00 00 00 00 00 00 00 00 00 00 00 00 00 00 00 00 00 00 00 00 00 00 00 00 00 00 00 00 00 00 00 00 00 00 00 00 00 00 00 00 00 00 00 00 00 00 00 06 
05 00 00 00 00 00 00 00 00 00 00 00 00 00 00 07 04 04 04 04 00 00 00 00 00 00 00 00 00 00 00 00 00 00 00 00 00 00 00 00 00 00 00 00 00 00 00 00 00 00 00 00 00 00 00 00 00 00 00 00 00 00 00 00 00 00 00 00 00 00 00 00 00 00 00 00 00 00 06 04 
05 00 00 00 00 00 00 00 00 00 00 00 00 00 08 07 04 04 04 00 00 00 00 00 00 00 00 00 00 00 00 00 00 00 00 00 00 06 06 06 06 06 06 06 06 06 06 00 00 00 00 00 00 00 00 00 00 00 00 00 00 00 00 00 00 00 00 00 00 00 00 00 00 00 00 00 06 06 06 04 
05 00 00 00 00 00 00 00 00 00 00 00 00 00 07 04 04 04 04 06 06 06 06 06 06 00 00 00 00 00 00 00 00 00 06 06 06 04 04 04 04 04 04 04 00 00 00 00 00 00 00 00 00 00 00 06 06 06 06 06 06 06 06 06 06 06 06 06 06 06 06 06 06 06 06 06 04 04 04 04 
05 00 00 00 00 00 00 00 00 00 00 00 00 08 07 04 04 04 04 04 04 04 04 04 04 06 06 06 00 00 00 00 00 00 04 04 00 00 00 00 00 00 00 00 00 00 00 00 00 00 00 00 00 00 06 04 04 04 04 04 04 04 04 04 04 04 04 04 04 04 04 04 04 04 04 04 04 04 04 04 
05 00 00 00 00 00 00 00 00 00 00 00 00 07 04 04 04 04 04 04 00 00 00 00 00 00 00 00 00 00 00 00 00 00 00 00 00 00 00 00 00 00 00 00 00 00 00 00 00 00 00 00 00 00 00 00 00 00 00 04 04 04 04 04 04 04 04 04 04 04 04 04 04 04 04 04 04 04 04 04 
05 00 00 00 00 00 00 00 00 00 00 00 00 07 04 04 04 04 04 00 00 00 00 00 00 00 00 00 00 00 00 00 00 00 00 00 00 00 00 00 00 00 00 00 00 00 00 00 06 06 06 00 00 00 00 00 00 00 00 00 00 00 00 00 00 00 00 00 00 00 00 00 00 00 00 04 04 04 04 04 
05 00 00 00 00 00 00 00 00 00 00 00 08 07 04 04 04 04 04 00 00 00 00 00 00 00 00 00 00 00 00 00 00 06 06 06 06 06 06 00 00 00 00 00 00 00 00 00 04 04 04 06 00 00 00 00 00 00 00 00 00 00 00 00 00 00 00 00 00 00 00 00 00 00 00 00 00 04 04 04 
05 00 00 00 00 00 00 00 00 00 00 08 07 04 04 04 04 04 00 00 00 00 00 00 00 00 00 00 06 06 06 06 06 04 04 04 04 04 04 06 06 06 06 06 00 00 00 00 00 00 04 04 06 00 00 00 00 00 00 00 00 00 00 00 00 00 00 00 00 00 00 00 00 00 00 00 00 00 00 04 
05 00 00 00 00 00 00 00 00 08 08 07 04 04 04 04 04 00 00 00 00 00 00 00 00 00 00 06 04 04 04 04 04 04 04 04 04 04 04 04 04 04 04 04 06 00 00 00 00 00 00 04 04 06 00 00 00 00 00 00 00 00 00 00 00 00 00 00 00 00 00 00 00 00 00 00 00 00 00 04 
05 00 00 00 00 00 00 00 08 07 04 04 04 04 04 04 00 00 00 00 00 00 00 00 00 06 06 04 04 04 04 04 04 00 00 00 00 00 00 00 04 04 04 04 04 06 00 00 00 00 00 00 00 00 00 00 00 00 00 00 00 00 06 06 06 06 06 06 06 06 06 06 06 00 00 00 00 00 00 00 
05 00 00 00 00 00 00 08 07 04 04 04 04 04 04 00 00 00 00 00 00 00 00 00 06 04 04 04 04 04 04 04 00 00 00 00 00 00 00 00 00 04 04 04 04 04 00 00 00 00 00 00 00 00 00 00 00 00 00 00 00 06 04 04 04 04 04 04 04 04 04 04 04 06 00 00 00 00 00 00 
05 00 00 00 00 00 00 07 04 04 04 04 04 04 00 00 00 00 00 00 06 06 06 06 06 04 04 04 04 04 04 04 00 00 00 00 00 00 00 00 00 00 04 04 04 04 00 00 00 00 00 00 00 00 00 00 00 00 00 00 00 04 04 04 04 04 00 00 04 04 04 04 04 04 06 00 00 00 00 00 
00 00 00 00 00 00 00 07 04 04 00 00 00 00 00 00 00 00 00 00 04 04 04 04 04 04 04 04 04 04 04 00 00 00 00 00 00 00 00 00 00 00 00 04 04 04 00 00 00 00 00 00 00 00 00 00 00 00 00 00 00 00 00 00 00 00 00 00 00 00 04 04 04 04 04 00 00 00 00 00 
00 00 00 00 00 00 00 07 04 00 00 00 00 00 00 00 00 00 00 00 00 00 00 00 00 00 00 04 04 04 04 00 00 00 00 00 00 00 00 00 00 00 00 00 00 00 00 00 00 00 06 00 00 00 00 00 00 00 00 00 00 00 00 00 00 00 00 00 00 00 00 04 04 04 04 00 00 00 00 00 
00 00 00 00 00 00 00 07 04 00 00 00 00 00 00 00 00 00 00 00 00 00 00 00 00 00 00 04 04 00 00 00 00 00 00 00 00 00 00 00 00 00 00 00 00 00 00 00 00 06 04 06 00 00 00 00 00 06 06 00 00 00 00 00 00 00 00 00 00 00 00 00 04 04 04 06 00 00 00 00 
00 00 00 00 00 00 00 00 00 00 00 00 00 00 00 00 00 00 00 00 00 00 00 00 00 06 06 04 04 00 00 00 00 00 00 00 00 00 00 00 00 00 00 00 00 00 00 00 06 04 04 04 06 00 00 00 00 04 04 06 06 06 06 06 06 00 00 00 00 00 00 00 00 00 04 04 00 00 00 06 
00 00 00 00 00 00 00 00 00 00 00 00 00 00 00 00 00 00 00 00 00 06 06 06 06 04 04 04 04 06 06 06 06 06 06 06 06 06 06 00 00 00 00 00 00 00 06 06 04 04 04 04 04 06 06 06 06 04 04 04 04 00 00 00 00 00 00 00 00 00 00 00 00 00 04 04 06 06 06 04 
00 00 00 00 00 00 00 00 00 00 00 00 00 08 08 08 08 08 08 06 06 04 04 04 04 04 04 04 04 04 04 04 04 04 04 04 04 04 04 06 06 06 00 00 06 06 04 04 04 04 04 04 04 04 04 04 04 04 04 04 04 00 00 00 00 00 00 00 00 00 00 00 00 00 00 04 04 04 04 04 
08 08 08 08 08 08 08 08 08 08 08 08 08 07 07 07 07 04 04 04 04 04 04 04 04 04 04 04 04 04 04 04 04 04 04 04 04 04 04 04 04 04 06 06 04 04 04 04 04 04 04 04 04 04 04 04 04 04 04 04 04 06 06 06 06 06 06 06 06 06 06 06 06 06 06 04 04 04 04 04 
