2 2
05 05 05 05 05 05 05 05 05 05 05 05 05 05 05 05 05 05 05 05 05 05 05 05 05 05 05 05 05 05 05 05 05 05 05 05 05 05 05 05 
00 00 00 00 00 00 00 00 00 00 00 00 00 00 00 00 00 00 00 00 00 00 00 00 00 00 00 00 00 00 00 00 00 00 00 00 00 00 05 09 
00 00 00 00 00 00 00 00 00 00 00 00 00 00 00 00 00 00 00 00 00 00 00 00 00 00 00 00 00 00 00 00 00 00 00 00 00 00 05 09 
00 00 00 00 00 013 012 011 010 011 012 013 00 00 00 00 00 00 00 00 00 00 00 00 00 00 00 00 00 00 00 00 00 00 00 00 00 00 05 09 
00 00 00 00 00 00 00 00 09 00 00 00 00 00 00 00 00 016 016 016 016 015 014 013 012 011 010 011 012 013 014 015 016 016 016 016 00 00 05 09 
00 00 00 00 00 00 00 00 09 00 00 00 00 00 00 00 00 00 00 00 00 00 00 00 00 00 09 00 00 00 00 00 00 00 00 00 00 00 05 09 
00 00 00 00 00 00 00 00 09 00 00 00 00 00 00 00 00 00 00 00 00 00 00 00 00 00 09 00 00 00 00 00 00 00 00 00 00 00 05 09 
00 00 00 00 00 00 00 00 09 00 00 00 00 00 00 00 00 00 00 00 00 00 00 00 00 00 09 00 00 00 00 00 00 00 00 00 00 00 05 09 
010 011 012 013 014 013 012 011 010 011 012 013 014 00 00 00 00 00 00 00 00 00 00 00 00 00 09 00 00 00 00 00 00 00 00 00 00 00 05 09 
00 00 00 00 00 00 00 00 09 00 00 00 00 00 00 00 00 00 00 00 00 00 00 00 00 00 09 00 00 00 00 00 00 00 00 00 00 00 05 09 
00 00 00 00 00 00 00 00 09 00 00 00 00 00 00 00 00 00 00 00 00 00 00 00 00 011 010 011 013 013 012 011 010 011 00 00 00 00 05 09 
00 00 00 00 00 00 00 00 09 00 00 00 00 00 00 00 00 00 00 00 00 00 00 00 00 00 09 00 00 00 00 00 09 00 00 00 00 00 05 09 
00 00 00 00 00 00 00 00 09 00 00 00 00 00 00 015 014 012 011 010 011 012 00 00 00 00 09 00 00 00 00 00 09 00 00 00 00 00 05 09 
00 00 00 00 00 00 00 00 09 00 00 00 00 00 00 00 00 00 00 09 00 00 00 00 00 00 09 00 00 00 00 00 09 00 00 00 00 00 05 09 
00 00 00 00 00 00 00 00 09 00 00 00 00 00 00 00 00 00 00 09 00 00 00 00 00 00 09 00 00 00 00 00 09 00 00 00 012 011 010 09 
011 012 00 00 00 00 00 00 09 00 00 00 00 00 00 00 00 00 00 09 00 00 00 00 00 00 09 00 00 00 00 00 09 010 011 00 00 00 05 09 
00 00 00 00 00 013 012 011 010 011 010 011 012 013 014 00 00 00 00 09 00 00 00 00 00 011 010 011 012 013 012 011 010 011 00 00 00 00 05 09 
00 00 00 00 00 00 00 00 09 00 09 00 00 00 00 00 00 00 00 09 00 00 00 00 00 00 09 00 00 00 00 00 09 00 00 00 00 00 05 09 
00 00 00 00 00 00 00 00 09 00 09 00 00 00 00 00 00 00 00 09 00 00 00 00 00 00 09 00 00 00 00 00 09 00 00 00 00 00 05 09 
00 00 00 00 00 00 00 00 09 00 09 00 00 00 00 00 00 00 00 09 00 00 00 00 00 00 09 00 00 00 00 00 09 00 00 00 00 00 05 09 
00 00 00 00 00 00 00 00 09 00 09 00 00 00 00 014 013 012 011 010 011 012 013 014 015 00 09 00 00 00 00 00 09 00 00 00 00 00 05 09 
00 00 00 00 00 013 012 011 010 00 09 00 00 00 00 00 00 00 00 09 00 00 00 00 00 00 09 00 00 00 00 00 09 00 00 00 00 00 05 09 
011 012 00 00 00 00 00 00 010 011 010 011 012 013 014 00 00 00 00 09 00 00 00 00 00 00 09 00 00 00 00 00 09 00 00 00 00 00 05 09 
00 00 00 00 00 00 00 00 09 00 09 00 00 00 00 00 00 00 00 09 00 00 00 00 00 00 09 00 00 00 00 00 010 011 012 013 012 011 010 09 
00 00 00 00 00 00 00 00 09 00 09 00 00 00 00 00 00 00 00 09 00 00 00 00 00 00 011 012 013 013 012 011 010 00 00 00 00 00 00 09 
00 00 00 00 00 00 00 00 09 00 09 00 00 00 00 00 00 00 011 010 011 012 00 00 00 00 09 00 00 00 00 00 09 00 00 00 00 00 00 09 
00 00 00 00 00 00 00 00 09 00 09 00 00 00 00 00 00 00 00 09 00 00 00 00 00 00 09 00 00 00 00 00 09 00 00 00 00 00 00 09 
00 00 00 00 00 00 00 00 09 00 09 00 00 00 00 00 00 00 00 09 00 00 00 00 00 00 09 00 00 00 00 00 09 00 00 00 00 00 00 09 
08 08 08 08 08 08 08 08 08 08 08 08 08 08 00 00 00 00 00 09 00 00 00 00 00 00 09 00 00 00 00 00 09 00 00 00 00 00 00 09 
07 07 07 07 07 07 07 07 07 07 07 07 07 07 08 08 08 08 08 08 08 08 08 08 08 08 08 08 08 08 08 08 08 08 08 08 08 08 08 08 
