2 2
05 05 05 05 05 05 05 05 05 05 05 05 05 05 05 05 05 05 05 05 05 05 05 05 05 05 05 05 05 05 05 05 05 05 05 05 05 05 05 05 
00 00 00 00 00 00 00 00 00 00 00 00 00 00 00 00 00 00 00 00 00 00 00 00 00 00 00 00 00 00 00 00 00 00 00 00 00 00 00 00 
00 00 00 00 00 00 00 00 00 00 00 00 00 00 00 00 00 00 00 00 00 00 00 00 00 00 00 00 00 00 00 00 00 00 00 00 00 00 00 00 
00 00 00 00 00 00 00 00 00 00 00 00 00 00 00 00 00 00 00 00 00 00 00 00 00 00 00 00 00 00 00 00 00 00 00 00 00 00 00 00 
00 00 00 00 00 00 013 012 011 010 011 012 013 014 00 00 00 00 00 00 00 00 00 00 00 00 00 00 00 00 00 00 00 00 00 00 00 00 00 00 
00 00 00 00 00 00 00 00 00 09 00 00 00 00 00 00 00 00 00 00 00 00 00 00 00 00 00 00 00 00 00 00 00 00 00 00 00 00 00 00 
00 00 00 00 00 00 00 00 00 09 00 00 00 00 00 00 00 00 00 00 00 00 00 00 00 00 00 00 00 00 08 08 00 00 00 00 00 00 00 011 
00 00 00 00 00 00 00 00 00 09 00 00 00 00 00 00 00 00 00 00 00 00 00 00 00 00 00 00 08 08 07 07 00 00 00 00 00 00 00 00 
00 00 00 00 00 00 00 00 00 09 00 00 00 00 00 00 00 00 00 00 00 00 00 00 00 00 00 00 07 07 07 07 08 08 00 00 00 00 00 00 
00 00 00 00 00 00 00 00 00 09 00 00 00 00 00 00 00 00 00 00 00 00 00 00 00 00 00 00 07 07 07 07 07 07 00 00 00 00 00 00 
00 00 00 00 00 014 014 012 011 010 010 00 00 00 00 00 00 00 00 00 00 00 00 00 00 00 00 00 07 07 07 07 07 07 00 00 00 00 00 00 
00 00 00 00 00 00 00 00 00 09 010 011 012 00 00 00 00 00 00 00 00 00 00 00 00 00 08 08 07 07 07 07 07 07 00 00 00 00 00 00 
00 00 00 00 00 00 00 00 00 09 00 00 00 00 00 00 00 00 00 00 00 00 00 00 00 00 07 07 07 07 07 07 07 07 00 00 00 00 012 011 
00 00 00 00 00 00 00 00 00 09 00 00 00 00 00 00 00 00 00 00 00 00 00 00 00 00 07 07 07 07 07 07 07 07 00 00 00 00 00 00 
00 00 00 00 00 00 00 00 00 09 00 00 00 00 00 00 00 00 00 00 00 00 00 00 00 00 07 07 07 07 07 07 07 07 00 00 00 00 00 00 
00 00 00 00 00 00 00 00 00 09 00 00 00 00 00 00 00 00 00 00 00 00 00 00 08 08 07 07 07 07 07 07 07 07 08 08 00 00 00 00 
00 00 00 00 00 00 00 00 00 010 011 012 013 014 015 00 00 00 00 00 00 00 00 00 07 07 07 07 07 07 07 07 07 07 07 07 00 00 00 00 
00 00 00 00 015 014 013 012 011 010 00 00 00 00 00 00 00 00 00 00 00 00 00 00 07 07 07 07 07 07 07 07 07 07 07 07 00 00 00 00 
00 00 00 00 00 00 00 00 00 09 00 00 00 00 00 00 00 00 00 00 00 00 00 00 07 07 07 07 07 07 07 07 07 07 07 07 00 00 00 00 
00 00 00 00 00 00 00 00 00 09 00 00 00 00 00 00 00 00 00 00 00 00 08 08 07 07 07 07 07 07 07 07 07 07 07 07 00 00 012 011 
00 00 00 00 00 00 00 00 00 09 00 00 00 00 00 00 00 00 00 00 00 00 07 07 07 07 07 07 07 07 07 07 07 07 07 07 00 00 00 00 
00 00 00 00 00 00 00 00 00 09 00 00 00 00 00 00 00 00 00 00 00 00 07 07 07 07 07 07 07 07 07 07 07 07 07 07 00 00 00 00 
00 00 00 00 00 00 00 00 00 09 00 00 00 00 00 00 00 00 00 00 00 00 07 07 07 07 07 07 07 07 07 07 07 07 07 07 00 00 00 00 
00 00 00 00 00 010 011 011 011 010 011 011 010 00 00 00 00 00 00 00 08 08 07 07 07 07 07 07 07 07 07 07 07 07 07 07 00 00 00 00 
00 00 00 013 012 010 00 00 00 09 00 00 010 012 013 014 00 00 00 00 07 07 07 07 07 07 07 07 07 07 07 07 07 07 07 07 00 00 00 00 
00 00 00 00 00 00 00 00 00 09 00 00 00 00 00 00 00 00 00 00 07 07 07 07 07 07 07 07 07 07 07 07 07 07 07 07 00 00 00 00 
00 00 00 00 00 00 00 00 00 09 00 00 00 00 00 00 00 00 00 00 07 07 07 07 07 07 07 07 07 07 07 07 07 07 07 07 00 00 00 00 
00 00 00 00 00 00 00 00 00 09 00 00 00 00 00 00 00 00 08 08 07 07 07 07 07 07 07 07 07 07 07 07 07 07 07 07 00 00 00 00 
08 08 08 08 08 08 00 00 00 09 00 00 00 00 00 00 08 08 07 07 07 07 07 07 07 07 07 07 07 07 07 07 07 07 07 07 00 00 00 00 
07 07 07 07 07 07 08 08 08 08 08 08 08 08 08 08 07 07 07 07 07 07 07 07 07 07 07 07 07 07 07 07 07 07 07 07 08 08 08 08 
